111111111111111111111
100000000010000000001
101111111110100000001
1000000001C0101000001
101000000111101000101
101000000000001000101
101000001111111100101
1P10000000000000001E1
111111111111111111111