111111
1P00C1
111111
10E001
111111