11111111111111111111111111111
1P001C000000000C1000000000001
10001100000000001010CCCCCCCC1
10000000000000001010CCCCCCCC1
10001C000000000C1011111111111
10000000000000001000000000001
10001100000000001111111111101
1E001C000000000C0000000000001
11111111111111111111111111111