111111111111111
1000000000000E1
1P1111111111111
1000000000000C1
111111111111111